4 11 0 0 0 0 0 0 0 0 0 0 0 0 0 0 0 0 0 0 0 0 0 0 16
4 11 0 0 0 0 0 0 0 0 0 0 0 0 0 0 0 0 0 0 0 0 0 0 16
4 11 0 0 0 0 0 0 0 0 0 0 0 0 0 0 0 0 0 0 0 0 0 0 16
4 11 0 0 0 0 0 0 0 0 0 0 0 0 0 0 0 0 0 0 0 0 0 0 16
4 11 0 0 0 0 0 0 0 0 0 0 0 0 0 0 0 0 0 0 0 0 0 0 16
4 11 0 0 0 0 0 0 0 0 0 0 0 0 0 0 0 0 0 0 0 0 0 0 16
4 11 0 0 0 0 0 0 0 0 0 0 0 0 0 0 0 0 0 0 0 0 0 0 16
4 11 0 0 0 0 0 0 0 0 0 0 0 0 0 0 0 0 0 0 0 0 0 0 16
35 11 0 0 0 0 0 0 0 0 0 0 0 0 0 0 0 0 0 0 0 0 0 0 16
35 11 0 0 0 0 0 0 0 0 0 0 0 0 0 0 0 0 0 0 0 0 0 0 16
4 11 0 0 0 0 0 0 0 0 0 0 0 0 0 0 0 0 0 0 0 0 0 0 16
4 11 18 0 0 0 0 0 0 0 0 0 0 0 0 0 0 0 0 0 0 0 0 0 16
4 11 0 0 0 0 0 0 0 0 0 0 0 0 0 0 0 0 0 0 0 0 0 0 16
4 11 0 0 0 0 0 0 0 0 0 0 0 0 0 0 0 0 0 0 0 0 0 0 16
4 11 0 0 0 0 0 0 0 0 0 0 0 0 0 0 0 0 0 0 0 0 0 0 16
4 11 15 15 15 15 15 15 15 0 0 0 0 0 0 0 0 0 0 0 0 0 0 0 16
4 9 8 8 8 8 8 8 8 11 0 0 0 0 0 0 0 0 0 0 0 0 0 0 16
4 1 1 1 1 1 1 1 1 11 0 0 0 0 0 0 0 0 0 0 0 0 0 0 16
4 1 1 1 1 1 1 1 1 11 0 0 0 0 0 0 0 0 0 0 0 0 0 0 16
4 1 1 1 1 1 1 1 1 11 0 0 0 0 0 0 0 0 0 0 0 0 0 0 16
4 1 1 1 1 1 1 1 1 11 0 0 0 0 0 0 0 0 0 0 0 0 0 0 16
4 1 1 1 1 1 1 1 1 11 0 0 0 0 0 15 15 15 15 0 0 0 0 14 10
4 1 1 1 1 1 1 1 1 13 1 1 1 5 8 8 8 8 8 11 0 0 16 10 35
7 3 3 3 3 3 3 1 1 1 1 1 1 6 35 35 35 35 35 13 15 15 14 35 35
35 35 35 35 35 35 35 7 3 3 3 3 6 35 35 35 35 35 35 9 8 8 10 35 35 