4 11 0 0 0 0 0 0 0 11 0 0 0 0 0 0 0 0 0 0 16 0 0 0 16
4 11 0 0 0 0 0 0 0 11 0 0 39 0 0 0 0 0 0 0 16 0 0 0 16
4 11 0 0 0 0 0 0 0 11 40 0 0 0 0 0 0 40 0 0 16 0 27 0 16
4 11 0 0 39 0 0 0 0 11 0 0 0 0 0 0 0 0 0 0 16 0 0 0 16
4 11 0 0 0 0 0 0 0 11 0 0 0 0 0 0 0 0 0 0 16 0 0 0 16
4 11 0 0 0 0 0 0 0 11 0 0 0 0 0 0 0 0 39 0 16 0 0 39 16
4 11 0 0 0 0 39 0 0 11 0 0 0 0 0 0 40 0 0 0 16 0 0 0 16
4 11 0 0 0 0 0 0 0 13 15 15 14 37 36 36 13 0 0 0 16 0 0 0 16
35 11 0 0 0 0 0 0 0 9 8 8 10 0 0 0 9 13 15 15 14 0 0 0 16
35 11 0 0 0 39 0 0 0 0 24 0 0 0 0 0 0 9 8 8 10 0 0 0 16
4 11 0 0 0 0 0 0 0 0 0 0 0 0 0 0 27 0 0 0 0 0 0 0 16
4 11 18 0 0 0 0 0 0 0 0 0 0 0 0 0 0 0 0 0 0 0 0 0 16
4 11 0 0 0 0 0 39 0 0 0 0 0 0 0 0 0 0 0 0 39 0 0 0 16
4 11 0 0 24 0 0 0 0 0 0 27 0 0 39 0 0 0 0 0 0 0 0 0 16
4 11 0 0 0 0 0 0 0 0 0 0 0 0 0 0 0 0 0 0 0 0 0 0 16
4 13 15 15 15 15 15 15 15 0 0 0 0 0 24 0 0 0 0 0 0 0 0 0 16
4 9 8 8 8 8 8 8 8 11 0 0 0 0 0 0 0 0 0 0 0 0 0 0 16
4 1 1 1 1 1 1 1 1 11 0 0 0 0 0 0 0 0 0 0 0 0 0 0 16
4 1 1 1 1 1 1 1 1 11 0 0 0 39 0 0 0 0 0 39 0 0 0 0 16
4 1 1 1 1 1 1 1 1 11 0 0 0 0 0 0 0 0 0 0 0 0 0 0 16
4 1 1 1 1 1 1 1 1 11 0 0 0 0 0 0 0 0 0 0 0 0 0 0 16
4 1 1 1 1 1 1 1 1 13 0 0 0 32 15 15 15 15 15 0 0 0 0 14 10
4 1 1 1 1 1 1 1 1 9 37 36 36 36 9 8 8 8 8 11 0 0 16 10 35
7 3 3 3 3 3 3 1 1 1 1 1 1 6 35 35 35 35 35 13 15 15 14 35 35
35 35 35 35 35 35 35 7 3 3 3 3 6 35 35 35 35 35 35 9 8 8 10 35 35 