4 11 0 0 0 0 0 0 0 11 0 0 0 0 0 0 0 0 0 0 16 0 0 0 0 0 0 0 0 0 0 0 0 0 0 0 0 0 0 0 0 0 0 0 0 0 0 0 16 5
4 11 0 0 0 0 0 0 0 11 0 0 39 0 0 0 0 0 0 0 16 0 0 0 0 0 0 0 0 0 0 0 0 0 0 0 22 0 0 0 0 0 0 0 0 0 0 0 16 5
4 11 0 0 0 0 0 22 0 11 40 0 0 0 0 0 0 40 0 0 16 0 27 0 0 0 0 0 0 0 0 40 0 0 0 0 0 0 0 0 30 0 40 0 0 0 0 0 16 5
4 11 0 0 39 0 0 0 0 11 0 0 0 0 0 0 0 0 0 0 16 0 0 0 0 0 0 0 0 0 0 0 0 0 0 0 0 0 0 0 0 0 0 0 0 0 0 0 16 5
4 11 0 0 0 0 0 0 0 11 0 0 0 0 0 0 0 0 0 0 16 0 0 0 0 0 0 0 0 0 0 0 0 0 0 18 0 0 0 0 0 0 0 0 0 0 0 0 16 5
4 11 0 0 0 0 0 0 0 11 0 0 0 0 0 0 0 0 39 0 16 0 0 39 0 0 0 25 0 0 0 0 0 0 0 0 0 0 0 0 0 0 0 0 0 0 39 0 16 5
4 11 0 0 0 0 39 0 0 11 22 0 0 0 0 0 40 0 0 0 16 0 0 0 0 0 0 0 0 0 0 0 0 0 0 0 0 0 0 0 0 0 0 0 0 0 0 0 16 5
4 11 0 0 0 0 0 0 0 13 15 15 14 37 36 36 13 0 0 0 16 0 0 0 0 0 0 0 0 0 0 0 0 0 0 0 0 0 29 0 0 0 0 0 0 0 0 0 16 5
35 11 0 0 0 0 0 0 0 9 8 8 10 0 0 0 9 13 15 15 14 0 0 0 30 0 0 40 0 0 0 0 0 0 39 0 0 0 0 0 0 0 40 0 0 0 0 0 16 5
35 11 0 0 0 39 0 0 0 33 24 0 0 0 0 0 0 9 8 8 10 0 0 0 0 0 0 0 0 0 0 0 0 0 0 0 0 0 0 0 0 0 0 0 0 0 0 0 16 5
4 11 0 0 0 0 0 0 0 0 0 0 0 0 0 0 27 0 0 0 0 0 29 0 0 0 0 0 18 0 30 0 0 0 0 0 0 0 0 0 0 0 0 0 0 0 0 0 16 5
4 11 18 0 0 0 0 0 0 0 0 0 0 0 0 0 0 0 0 0 0 0 0 0 25 0 0 0 0 0 0 0 25 0 0 0 0 0 0 0 0 0 30 0 0 25 0 0 16 5
4 11 0 0 0 0 0 39 0 0 0 0 0 0 0 0 0 0 0 0 39 0 0 0 0 0 0 0 0 0 0 0 0 0 0 0 0 0 0 0 0 0 0 0 0 0 0 0 16 5
4 11 0 0 24 0 0 0 0 0 0 27 0 0 39 0 0 0 0 0 0 0 0 0 0 0 0 0 0 0 0 0 0 0 40 0 0 33 0 0 18 0 0 0 0 0 0 0 16 5
4 11 0 0 0 0 0 0 30 0 0 0 0 0 0 0 0 0 0 0 0 0 0 0 0 0 0 0 0 0 0 0 0 0 0 0 0 0 0 0 0 0 0 0 0 0 0 0 16 5
4 13 15 15 15 15 15 15 15 0 0 0 0 0 24 0 0 0 0 0 0 0 0 0 0 0 0 0 0 0 0 0 0 0 0 0 0 0 0 0 0 0 0 0 39 0 0 0 16 5
4 9 8 8 8 8 8 8 8 11 0 0 0 0 0 0 0 0 0 0 0 0 0 39 0 0 0 29 0 0 0 0 0 0 0 0 0 0 0 0 0 0 30 0 0 0 0 0 16 5
4 1 1 1 1 1 1 1 1 11 0 0 0 0 0 0 0 0 0 0 0 0 0 0 0 0 0 0 0 0 0 25 0 0 0 0 0 0 0 0 0 0 0 0 0 0 0 0 16 5
4 1 1 1 1 1 1 1 1 11 0 0 0 39 0 0 0 18 0 39 0 0 0 0 0 0 0 0 0 0 0 0 0 0 0 0 0 0 0 0 0 0 0 0 0 0 0 0 16 5
4 1 1 1 1 1 1 1 1 11 0 0 0 0 0 0 0 0 0 0 0 0 0 22 0 0 0 0 0 0 0 39 0 0 0 0 0 0 0 0 22 0 0 0 0 0 0 0 16 5
4 1 1 1 1 1 1 1 1 11 0 0 0 0 0 0 0 0 0 0 0 0 0 0 0 0 0 0 0 0 0 0 0 0 0 0 0 0 0 0 0 0 0 25 0 0 0 0 16 5
4 1 1 1 1 1 1 1 1 13 0 0 0 32 15 15 15 15 15 0 0 0 0 15 15 0 0 0 0 0 0 0 0 0 0 0 0 0 0 0 0 15 15 15 15 15 15 15 14 5
4 1 1 1 1 1 1 1 1 9 37 36 36 36 9 8 8 8 8 11 0 0 16 10 8 13 15 15 15 18 15 15 15 15 15 14 0 0 0 13 14 9 8 8 8 8 8 8 8 5
7 3 3 3 3 3 3 1 1 1 1 1 1 6 35 35 35 35 35 13 15 15 14 35 35 9 8 8 8 8 8 8 8 8 8 10 37 36 36 9 9 7 1 1 1 1 1 1 1 5
35 35 35 35 35 35 35 7 3 3 3 3 6 35 35 35 35 35 35 9 8 8 10 35 35 35 35 35 35 35 35 35 35 35 35 7 3 3 3 6 35 35 7 3 3 3 3 3 3 6